180 150W  120W  90W   60W   30W  000   30E   60E   90E   120E  150E 180
|    |     |     |     |     |    |     |     |     |     |     |     |
+90N-+-----+-----+-----+-----+----+-----+-----+-----+-----+-----+-----+
|          . _..::__:  ,-"-"._       |7       ,     _,.__             |
|  _.___ _ _<_>`!(._`.`-.    /        _._     `_ ,_/  '  '-._.---.-.__|
|.{     " " `-==,',._\{  \  / {)     / _ ">_,-' `                mt-2_|
+ \_.:--.       `._ )`^-. "'      , [_/(                       __,/-' +
|'"'     \         "    _L       oD_,--'                )     /. (|   |
|         |           ,'         _)_.\\._<> 6              _,' /  '   |
|         `.         /          [_/_'` `"(                <'}  )      |
+30N       \\    .-. )          /   `-'"..' `:._          _)  '       +
|   `        \  (  `(          /         `:\  > \  ,-^.  /' '         |
|             `._,   ""        |           \`'   \|   ?_)  {\         |
|                `=.---.       `._._       ,'     "`  |' ,- '.        |
+000               |    `-._        |     /          `:`<_|h--._      +
|                  (        >       .     | ,          `=.__.`-'\     |
|                   `.     /        |     |{|              ,-.,\     .|
|                    |   ,'          \   / `'            ,"     \     |
+30S                 |  /             |_'                |  __ x/     +
|                    | |                                 '-'  `-'   \.|
|                    |/                                        "    / |
|                    \.                                            '  |
+60S                                                                  +
|                     ,/           ______._.--._ _..---.---------._   |
|    ,-----"-..?----_/ )      _,-'"             "                  (  |
|.._(                  `-----'                                      `-|
+90S-+-----+-----+-----+-----+----+-----+-----+-----+-----+-----+-----+
Map 1998 Matthew Thomas. Freely usable as long as this line is included
Modified for ITL course 2024. X marks the solution.